111111111111111111
10E000000000000P01
10000C000C00000001
100000000000000001
100000000000000001
111111111111111111