1111111111111111111111
100000P000000000000001
100000C0E0000000000001
1000000000001100000001
1000111000000000000001
1000000000000000000001
1000000000000000000001
1000000000C00000000001
1000000000000000000001
1000000000000000000001
1000000000000000000001
1111111111111111111111