111111111111111111
10E000000000000001
100000C00000000001
1000000P0000110001
100011100000000001
100000000000000001
100000000000000001
111111111111111111