111111111111111111
10E001001110001P11
10001C100C00000101
100000000000000001
100000000000000001
111111111111111111