111111111111111111
10E000000000000001
100000C000C000C001
1000000000P0000001
100000000000000001
111111111111111111