111111111111111111
100000P00000000001
100000C00000000001
100000000000110001
100011100000000001
1000000E0000000001
100000000000000001
111111111111111111