11111111111111111
1P000000000000001
111110CCC01111101
1CCC111111100C101
10000000000011101
10111111110000001
1010CCCC011111111
10000000000000CC1
10111111110000CC1
101C0CC0C11111111
100000000000000E1
11111111111111111