1111111111111
1000C000000E1
1000000000001
1111111111111