1111111111111
1P00C000000E1
1000000000001
1111111011111